####################
#       #          #
#  /    #   @      #
#  ##   #   ####   #
#   @       !      #
#   #########      #
#   #       #      #
#   #   @   ###### #
#   ######         #
#       !    ####  #
#   ######         #
#       #   @      #
#   ######   ####  #
#   #          !   #
# ! #   #######    #
#   #   #     ###  #
#   #   #  @    #  #
#   ### ###    D#  #
#                  #
####################