####################
#     #       #    #
#  @  #  /    #    #
#  ## ###  ## #    #
#  !   #  @   #    #
#  ######@###@###  #
#  #      @     @  #
#  #  ##  #  @  #  #
#  #  ##  ####### @#
#  #     !       # #
#  # ########  ##  #
#    #   @  #  ##  #
#  ###@@#### #  ####
#  #    # !  @     #
#  #  ##########@# #
#     #     #      #
# !#  #  @  #  ###@#
#  #  ###   #  #D  #
#  #         @ # ! #
####################