####################
#     #   #        #
#  @  # #   # #### #
#  ## #@#####@#!   #
#  !#   #  @#  # ###
#  ######@####@#   #
# ##   #   # # @## #
#!!# #   # @ !#  #!#
## # ###@@####  @#@#
#  #     !    ##!###
#  ##########  #   #
#    #   @  #  #  ##
####@#@#### #  ##  #
#  # #  # !  @#    #
#@@#     ### ##@####
# ###### #@# ##    #
#     #  @ !   #@#@#
#  # #########@#   #
# /#         @ # !D#
####################