####################
#     #       #   @#
#  @  #  /    #  ! #
#  ## ###  ## # @  #
#  !          #    #
#  ###### ###@###  #
#  #   @  @     @  #
#  #  ##  # !@  #  #
#  #  ##  #######  #
#  #  @       @  # #
#  ### ######  ##@ #
#    #  @@  #  ##  #
#  ###  #### #  ## #
#  #  !   ! @     @#
#     #     #  @   #
# !#  #  @  #    #@#
#  #  ### @ #   D  #
#  #   @  !  @     #
####################