####################
#       #          #
#  /    #   @      #
#  ##   #   ####   #
#   @       !      #
#   #########      #
#   #       #      #
#   #   @   ###### #
#   ######  #@@D@@@#
#       !   # ###@@#
#   ######  #  !   #
#       #   @@@@@@@#
#   ######   ####  #
#   #          !   #
# ! #   #######    #
#   #   #     ###  #
#   #   #  @    #  #
#   ### ###     #  #
#                  #
####################