####################
#     #       #   @#
#  @  #  /    #  ! #
#  ## ###  ## # @  #
#  !      !   #    #
#  ###### ###@###  #
#  #   @  @     @  #
#  #  ##  #  @  #  #
#  #  ##  #######  #
#  #  @  !    @  # #
#  ### ######  ##@ #
#    #  @@  #  ##  #
#  ###  #### #  ## #
#  #  !   ! @  !  @#
#  #  #######  # # #
#     #     #  @   #
# !#  #  @  #  ###@#
#  #  ### @ #  #D# #
#  #   @  !  @   ! #
####################