##########
#   ! @ @D
#   #    #
#        #
#      # #
#@@@     #
#/    !  #
!

##########