####################
#       #          #
#  /D   #   @      #
#  ##   #   ####   #
#   @       !      #
#   #########      #
#   #       #      #
#   #   @   ###### #
#   ######         #
#       !    ####  #
#   ######         #
#       #   @      #
#   ######   ####  #
#   #          !   #
# ! #   #######    #
#   #   #     ###  #
#   #   #  @    #  #
#   ### ###     #  #
#                  #
####################