###############
#   !#     @ !D
#   ##        #
#             #
#             #
#@@@          #
#/            #
####     ######
              !