################
#   !#     @   D
#   ##         !
#              #
#              #
#@@@           #
#/             #
################